11111111111
1P1E1000001
100C1000001
1010101C001
11000011001
11000101001
11010001001
11111111111