11111111111111111111
1P0000010000000000E1
11101110111111111011
1C000000000000000001
10111110101110101111
10000000000000100001
10111011111110101111
1C000000C00000000001
11101111101111101111
11111111111111111111