111111111111111111111111111111
100000P000000100000000001E0001
101111111110000111111111111101
110000000000010000000000000001
101011011111010111111111111111
100010000001000000000000000001
101110111101011111111111111011
10001000C100000100000000000011
101111111101111111111111111101
100000000001000000000000001001
101011111101011111011111101101
100010000000000010000000000001
101111101111111111111101111101
111111111111111111111111111111